11111111111111111111111111111111
11001100000000000000000000000001
11P00000000001011000000000000C01
11111000000011C11000000000000001
100000000000111100000000C0000001
10000000000000000001011000000001
10000111100010000000000000000001
1000C000100010000000000000110C01
10000000111110111111000000110C01
100000C01E00000000010C0000000001
11111111111111111111111111111111