11111111111111111111
1PC111E1111011R11111
11111111111111111111