1111111
1000001
1111001
10E1001
1011001
10K0001
1000101
1C11101
100P101
1111111