1111111
1C000C1
1111001
10E1001
1011001
10K00C1
1000101
1C11101
100P1C1
1111111