11111111111111111111
1P111111111111111111
10111111111111111111
101
101
111