1111111
10000C1
1111001
10E1001
1011001
1000C01
1000101
1011101
100P1C1
1111111